1111111111111
10C1000C000C1
100CP11011001
100011E0000C1
1111111111111