1111111111
1P00C00E11
1C00100011
1011111111
1000000001
1111111111