11111111111111111111111111111
1P000000C00000000C00000000E11
11001111111001111110001111101
10000000000000000000010000001
11111000111100011110001111101
10000000010000000100000000001
1W0000000000000000000000000W1
11111111111111111111111111111
