11111111
1000P0E1
:10000001
11111111