11111111
1P0000E1
10000001
11111111