1111111111111
1P00000000C01
1100011110001
1010000000001
1000011111101
1E010000000C1
1111111111111
