1111111111111
1C10001E000C1
101C101001001
10001000010P1
1111111111111