1111111111111
1C000000100C1
1000P10010001
1C0001E0000C1
1111111111111