1111111111111
10C1000C000C1
100C011011001
1P0011E0000C1
1111111111111