1111111111111111111
1C000P0000000000001
1111011001011111C11
1E00000001C00000001
1111111111111111111
