11111111
1P0000E1
100C0C01
11111111