11111111111111
1P000C00000001
11011111000101
1C000000001C01
11111110001101
1C0000001E0011
11111111111111