111111111111111
1P0011E00000001
1110101100000C1
1C1000C00000111
1000C0000000001
111111111111111