111111111
10000P001
111101111
1E0000001
111111111
