11111111111111111111111111111
1P000000C00000000C00000000E11
11001111111001111110001111101
1000000000000000000001C000001
11111000111100011110001111101
100000000100000001C0000000001
100000C0000000000000000000001
11111111111111111111111111111
